4 4 4 4 4 4 4 4 4 4 4 4 4
4 2 2 2 2 2 4 2 2 2 2 2 4
4 2 3 2 2 2 4 2 2 2 3 2 4
4 2 2 2 2 2 4 2 2 2 2 2 4
4 2 2 2 2 2 2 2 2 2 2 2 4
4 2 2 2 2 0 2 0 2 2 2 2 4
4 4 4 4 2 2 5 2 2 4 4 4 4
4 2 2 2 2 0 2 0 2 2 2 2 4
4 2 2 2 2 2 2 2 2 2 2 2 4
4 2 2 2 2 2 4 2 2 2 2 2 4
4 2 3 2 2 2 4 2 2 2 3 2 4
4 2 2 2 2 2 4 2 2 2 2 2 4
4 4 4 4 4 4 4 4 4 4 4 4 4